11
111111111111111
111111111111111
111111111111111
111111111111111
111111111111111
111111111111111
111111111111111
111111111111111
111111111111111
111111111111111
111111111111111
111111111111111
111111111111111
111111111111111
111111111111111
111111111111111
111111111111111
111111111111111
111111111111111
111111111111111
11
000000000000001
000000010000000
000000100000000
000001000000000
000010000000000
000000000000000
100000000111111
100000000000000
100000000000000
000000000000000
000000000000000
000000000000111
000000010000000
000000010000000
000000010000000
000000011100000
000100000000000
000100000000000
000100000000000
000100010000000
0000