11
111111111111111
111111111111111
111111111111111
111111111111111
111111111111111
111111111111111
111111111111111
111111111111111
111111111111111
111111111111111
111111111111111
111111111111111
111111111111111
111111111111111
111111111111111
111111111111111
111111111111111
111111111111111
111111111111111
111111111111111
11
000000000000000
000000000000000
000000000000000
000000000000000
000001110000011
000011100000001
000000000000001
000000000000001
000000000000000
111100000000000
000100000000000
000000000000000
000000000010000
000000000010001
000100001110001
111100001000000
000000000000000
000000000000000
000000000000000
000000010000000
0000